X0011110101111110101000110011110010111101011001
00100111000011110100100111010010001110001111000
00000111110001001010010011100001110101000101010
10010101001001000001000010001100000011110000011
10010001100011110000011110001101010101110000000
01100100010001000010001011111000011111100000011
01101101010110011010101010101010001111010001000
10011001001000010001000000011111011101101001000
11110000001000000000000000001111111111111010001
1010101101001010101010100011101010010111010100X