0X111111101111111111
00110111100000011110
00000000001111000000
10111111101111011111
1011110000111001100X
00011001100000000011
11000011111111111111